╔═╦═╦═╦═╦═╦═╦═╦═╦═╦═╦═╦═╦═╦═╦═╗
║■║   ║   ║       ║   ║   ║   ║
║ ║ ║ ║ ║ ║ ║ ║ ║ ║ ║ ║ ║ ║ ║ ║
║ ║ ║   ║ ║ ║ ║ ║ ║ ║ ║ ║   ║ ║
║ ║   ║ ║ ║ ║ ╚═╝ ║ ║ ║ ║ ║ ║ ║
║   ║ ║   ║ ║       ║ ║   ║   ║
║ ║ ║ ║ ║ ║ ║ ║ ║ ║ ║ ║ ║ ║ ║ ║
║ ║   ║ ║   ║ ║ ║ ║   ║   ║   ║
║ ║ ║ ║ ╠══ ║ ║ ╠═╣ ║ ║ ║ ║ ║ ║
║   ║   ║       ║ ║ ║ ║ ║ ║   ║
║ ╔═╣ ║ ║ ║ ║ ║ ║ ║ ║ ║ ║ ║ ║ ║
║   ║     ║   ║ ║   ║     ║ ║ ║
║ ║ ║ ║ ║ ║ ║ ║ ║ ║ ║ ║ ║ ║ ║ ║
║ ║ ║   ║ ║ ║         ║   ║ ║ ║
║ ║ ║ ║ ║   ║ ║ ╚═══╣ ║ ║ ╚═╝ ║
║       ╠═╗   ║     ║         ║
║ ║ ║ ║ ║ ║ ╔═╬═╗ ║ ║ ║ ║ ║ ║ ║
║   ║     ║ ║     ║ ║   ║*  ║ ║
║ ║ ║ ║   ║ ║ ║ ║ ║ ║ ║ ║ ║ ║ ║
║ ║   ║   ║ ║ ║   ║         ║ ║
║ ║ ║ ║ ║ ║ ║ ║ ║ ║ ║   ╚═╣ ║ ║
║ ║ ║ ║ ║     ║     ║     ║   ║
║ ║ ║ ║ ║ ║ ║ ║ ║ ║   ╚═══╣ ║ ║
║ ║ ║ ║ ║ ║ ║ ║   ║ ║       ║ ║
║ ║ ║ ║ ║ ║ ║ ║ ║ ║ ║ ║ ║ ║ ║ ║
║   ║   ║   ║   ║   ║       ║X║
╚═╩═╩═╩═╩═╩═╩═╩═╩═╩═╩═╩═╩═╩═╩═╝