╔═══╦═════╦═╦═╦═╦═╦═╦═╦═╦═══╦═╗
║■  ╠═╗   ║ ║ ║ ║ ║ ║ ║ ║   ║X║
║ ║ ║               ║ ║ ╠═    ║
║ ╠═╣ ╠═╦═╬═════╗   ║ ║ ╠═ ═══╣
║ ║ ║ ║ ║ ╠═╗   ╠═ ═╣ ║ ║   ║ ║
║ ║ ║ ║ ║ ║ ║   ║   ║ ║ ║ ║   ║
║   ║ ║ ║           ║ ║ ╚ ════╣
║ ║ ║ ║ ║   ╔═══╗   ║         ║
║ ║   ║ ║   ║   ║   ╠═══════╗ ║
║ ╚═══╣ ║   ║   ║     ╔═╦═╗ ║ ║
║     ║ ╠═══╣   ║   ║ ║ ║ ║   ║
║ ╔═╗ ║ ║           ╚═══════╝ ║
║ ║ ║ ║ ║ ║ ╔═══╗             ║
║ ║ ║ ║ ║ ║ ║   ║   ╔═════════╣
║ ║ ║ ║ ║ ║ ║ ║ ║   ║ ║ ║ ║ ║ ║
║     ║ ╚═══╝ ║ ║   ║ ║ ║ ║ ║ ║
║ ║ ║ ╚═══════╦═╣   ║ ║ ║ ║ ║ ║
║ ║ ║           ║   ║ ║ ║ ║ ║ ║
║ ║ ║ ║ ║ ║   ║ ║   ║ ║ ║ ║ ║ ║
╚═╩═╩═╩═╩═╩═╩═╩═╩═╩═╩═╩═╩═╩═╩═╝